KKKKKKKKKKKKK
KWKWKWKWKWKWK
KWKWKWKWKWKWK
KWKWKWKWKWKWK
KFGFGFGFGFGFK
KAAAAAAAAAAAK
KKKKKKKKKKKKK
KKKKKKKKKKKKK
KKWWKKKKWWKKK
KKWWKKKKWWKKK
KKKKKKKKKKKKK
KKKKKKKKKKKKK
KKKKKKKKKTKKK